% Source: http://www.game-sokoban.com/index.php?mode=level&lid=40862

###############
##    ##      #
##$$. ## $*** #
# $. * ##$.   #
#  *.. *  ..* #
#  *$. # $$$. #
##$.$* ## .** #
## @#  ##  #  #
###############
